85
............
.X........*.
.....*......
............
....*....*..
.*..........
..........*.
..*....*....
............
......*.....
.*........X.
............
