85
............
.X.......*..
............
......*.....
............
...*........
........*...
............
.....*......
............
..*.......X.
............
