150
......................
.X..................X.
..*................*..
...*..............*...
..........**..........
.........****.........
.........****.........
.........****.........
..........**..........
...*..............*...
..*................*..
.X..................X.
......................
